6 7
0 0
0 0 0 0 0 0
0 2 2 2 2 0
0 2 5 5 2 0 
0 2 5 5 2 0
0 2 5 5 2 0 
0 2 2 2 2 0
0 0 0 0 0 0